 NO ./Assets/north_wall.xpm
 SO ./Assets/south_wall.xpm
 WE ./Assets/cool_wall.xpm
 EA ./Assets/base_wall.xpm

 F 125,133,139
 C 0,255,243


         1111111111111111111111111
         1000000000110000000000001
         1011000001110000000000001
         1001000000000000000000001
 111111111011000001110000000000001
 100000000011000001110111111111111
 11110111111111011100000010001
 11110111111111011101010010001
 11000000110101011100000010001
 100000000000000011000000N001
 100000000000000011010100100011
 1100000111010101111101111010111
 11110111 1110101 1011110100011
 11111111 1111111 101111111111